Abigail	Abbie,Abby,Gail,Nabby
Ada	Adie
Adelaide	Addie,Adela,Dell,Della,Heidi
Adele,Adelle,Adela	Addie,Dell,Della
Adeline,Adelina,Adaline	Addie,Aline,Dell,Della
Adrienne,Adriana	Adie
Agatha	Aggie
Agnes	Aggie,Ness,Nessie
Aileen,Eileen,Alene	Allie,Lena
Alberta	Allie,Bertie
Alexandra,Alexandria	Alex,Alix,Alexa,Alla,Allie,Ali,Lexy,Sandra,Sandy
Alexis	Alex
Alfreda	Alfie,Alfy,Frieda,Freda,Freddie,Freddy
Alice,Alicia,Alyce,Alisa,Alissa,Alyssa	Allie,Ally,Ali,Elsie,Lisa
Alison,Allison,Alyson,Allyson	Allie,Ally,Ali
Althea	Thea
Amabel	Mabel,Mab,Mabs
Amanda	Mandy
Amber
Amelia	Amy,Millie,Milly
Amy,Aimee,Amie
Anastasia	Ana,Stacy,Stacey
Andrea	Andy
Angela,Angelica,Angelina,Angeline,Angel	Angie
Anita	Ana,Nita
Anna,Ann,Anne	Ann,Annie,Nancy,Nancie,Nance,Nan,Nana,Nanny,Nanette,Nannette,Nina
Annabel,Annabelle,Anabel	Ann,Anna,Bel,Belle,Bell
Annette,Annetta	Annie,Netta,Nettie,Netty
Antoinette	Nettie,Netty,Net,Netta,Toni,Tony,Toy,Toi
Antonia	Toni,Tony,Tonya,Tonia
April
Arabella,Arabel,Arabelle	Bel,Bell,Belle,Bella
Arlene,Arline,Arleen,Arlyne	Lena,Arly,Lynn
Ashley	Ash
Audrey	Dee
Augusta,Augustina	Aggy,Augie,Gussie,Gusty,Ina,Tina
Aurora	Rori
Barbara	Bab,Babs,Babbie,Barbie,Babette
Beatrice,Beatrix	Bea,Bee,Beattie,Trixie,Trissie
Belinda	Bel,Bell,Belle,Linda,Lindy,Lin,Lynn
Belle,Bell,Bel,Bella 
Berenice,Bernice	Bernie
Bertha,Berta	Bertie
Betty 
Beverly,Beverley	Bev
Blanche,Blanch
Bonnie,Bonny
Brenda	Brendie,Brandy
Brett,Bret,Bretta
Bridget,Bridgette,Brigid,Brigit	Biddie,Biddy,Bridie,Bridey,Brie,Bree,Brita
Brittany,Brittney,Britney	Brit,Britt,Brita,Brie
Camille,Camilla,Camile,Camila	Cammie,Cammy,Millie
Candace,Candice	Candy
Caren,Carin,Caryn	Carrie
Carla	Carlie
Carlotta,Carlota	Lotta,Lottie
Carmen
Carol,Carole,Carrol,Carroll,Karol	Carrie
Caroline,Carolyn,Carolina,Carlyne,Carline,Karoline	Carrie,Carry,Caddie,Caddy,Carlie,Carly,Callie,Cally,Carol,Lynn,Lynne,Lin
Cassandra	Cass,Cassie,Cassey,Casey,Sandra,Sandy
Catherine,Cathryn,Catheryn,Catharine,Cathleen	Cat,Cattie,Catty,Cathie,Cathy,Cassie,Kit,Kitty,Kittie
Cecilia,Cecillia,Cecelia,Cecile,Cecily,Cicely	Cissy,Sissy,Celia
Celeste	Celie,Lessie
Celestine,Celestina	Celie,Lessie,Tina
Celia	Celie,Cel
Celine,Celina 
Charity	Chattie,Chatty,Cherry
Charlotte	Lotta,Lottie,Lotty,Lola,Lolita,Chattie,Charlie
Cheryl	Cherie
Christine,Christina,Christiana	Chris,Christy,Christie,Christa,Chrissie,Kit,Tina
Clara,Clare,Clair,Claire
Clarice,Clarissa	Clara,Clare,Clair
Claudia	Claudie
Clementine,Clementina	Clem,Clemmie,Tina
Colleen,Coleen
Constance	Connie,Connee,Conny
Cora	Co,Cori,Corrie,Corey,Cory
Cordelia	Cordy,Cori,Delia
Corinne,Corinna,Corynne,Corrine,Corine,Corina	Cora,Cori,Corrie,Cory
Cornelia	Connie,Conny,Corny,Cori,Nell,Nellie
Courtney	Court,Courtie
Crystal,Chrystal	Crys,Chris
Cynthia	Cindy
Daisy,Daysie
Danielle,Daniela	Dani,Danny
Daphne	Daph,Daphie
Darlene,Darleen,Darlyne	Lena,Darla
Deborah	Debbie,Debby,Debra
Delia	Dell,Della
Dell,Della 
Denise,Denice	Denny
Diana,Diane,Dianne	Di
Dinah,Dina	Di
Dolores,Delores	Lola,Lolita
Dominique,Dominica	Minnie,Nicki,Nikki
Donna
Dora	Dorrie
Doreen,Dorene	Dorrie
Doris,Dorris	Dorrie
Dorothy,Dorothea	Dora,Dorrie,Doll,Dolly,Dodie,Dot,Dottie,Dotty,Dee
Edith,Edyth,Edythe	Edie,Edye,Dee
Edna	Eddie
Elaine,Helaine	Ellie,Elly,Lainie
Eleanor,Elinor,Eleonora,Eleonore,Elenore	Ella,Ellie,Elly,Nell,Nellie,Nelly,Nora,Lally,Lallie
Elisa,Eliza,Elisia,Elissa,Elise,Elyse,Elsa	
Elizabeth,Elisabeth	Betty,Bettie,Bet,Bett,Bette,Betta,Betsy,Betsey,Betsi,Beth,Bess,Bessie,Bessy,Bettina,Elsie,Elisa,Elsa,Eliza,Ellie,Elly,Ilse,Liz,Lizzy,Lizzie,Liza,Lisa,Lise,Lisette,Lizette,Lisbet,Lizbeth,Libby
Ella	Ellie,Elly,Nellie
Ellen 
Eloise,Heloise	Lois
Elsie 
Elvira	Elvie
Emily,Emilia	Em,Emmy,Emmie,Millie,Milly
Emma	Em,Emm,Emmy,Emmie
Erica,Erika,Ericka	Ricky,Rickie
Erin
Ernestine,Earnestine	Erna,Ernie,Tina
Estelle,Estella	Essie,Stella
Esther,Ester,Hester	Essie,Ettie,Etty,Hettie,Hetty
Ethel	Eth
Etta	Ettie
Eugenia,Eugenie	Gene,Genie
Eulalia	Eula,Lally,Lallie
Eunice	Euny,Eunie
Euphemia,Euphemie	Effie,Effy,Euphie,Phemie
Eustacia	Stacy,Stacey,Stacia
Eve,Eva	Evie
Eveline,Evelyn,Evelynne,Eveleen,Evelina	Eve,Evie,Evvie,Lynn
Evangeline,Evangelina	Eve,Evie,Angie,Lynn
Faith	Fae,Fay,Faye
Felicia,Felicity,Felice	Fee,Fel
Florence	Flo,Floy,Floss,Flossie,Flora,Florrie
Frances	Fan,Fannie,Fanny,Fran,Frannie,Franny,Francie,Francy,France,Frankie,Franky
Francesca,Francisca	Fran,Cesca
Francine	Fan,Fannie,Fanny,Fran,Frannie,Franny,Francie,Francy,France,Frankie,Franky
Frederica,Frederika,Fredericka	Freda,Freddie,Freddy,Ricky,Rickie
Gabrielle,Gabriela,Gabriella	Gabby,Gabi,Gaby
Genevieve	Gene,Ginny,Jenny,Viv
Georgina,Georgine	Georgie,Gina
Geraldine	Gerry,Gerrie,Gerri,Jerry,Dina
Gertrude	Gertie,Trudie,Trudy
Gillian,Jillian	Jill
Gina 
Gladys	Glad
Glenda	Glen
Gloria	Glory
Grace	Gracie
Gwendolen,Gwendolyn	Gwen,Gwenda,Wendy
Hannah,Hanna	Ann,Annie,Nana,Nanny
Harriet	Hattie,Hatty
Hazel
Heather	Hettie,Hetty
Helen,Helena,Elena,Ellen	Nell,Nellie,Nelly,Ellie,Elly,Lena,Lala,Lally,Lallie
Henrietta	Etta,Ettie,Etty,Hettie,Hetty,Nettie,Netty
Hester 
Hillary,Hilary	Hill,Hillie
Hilda,Hylda	Hildie
Holly
Hope
Ida
Imogen,Imogene	Immy,Immie
Irene	Renie,Rena
Iris
Isabel,Isabelle,Isabella	Bel,Bell,Belle,Bella,Issy
Jacqueline,Jacquelyn	Jackie,Jacky
Jane	Janie,Janey,Jenny,Jennie,Jen,Janet
Janet,Janette,Janetta	Jan,Nettie,Netty,Netta
Janice,Janis,Jenice	Jan
Jean,Jeanne	Jeanie,Jeannie
Jeannette,Jeannetta,Jeanette	Jeanie,Jeannie,Nettie,Netty,Netta
Jemima	Jem,Jemma,Mima,Mimi
Jennifer	Jen,Jenny,Jennie,Jenne
Jenny 
Jessica	Jess,Jessie
Jill 
Joanna,Joanne,Joann,Johanna,Joan	Jo,Jody
Joceline,Jocelyn	Jo,Lynn
Josephine	Jo,Josie,Josey,Jozy,Jody
Joyce	Joy
Judith	Judy,Judie,Jude,Jody,Jodie
Julia	Julie,Jule
Julianne,Juliana	Julie,Jule
Juliet,Juliette	Julie,Jule
June
Karen,Karin,Karyn	Kari,Karrie
Katherine,Katharine,Kathryn,Kathrine,Kathrynne,Katrina	Kate,Kathie,Kathy,Katie,Katy,Kay,Katty,Kattie,Kit,Kitty,Kittie
Kathleen,Kathlene,Kathlyn,Kathlynne	Kathie,Kathy,Katie,Katy,Katty,Kattie
Kelly,Kelley
Kimberly,Kimberley	Kim
Kristina,Kristin,Kristine,Kristen	Kris,Kristi,Kristy,Kristie,Krista
Laura	Laurie,Lauri,Lolly
Lauren,Laureen,Laurene,Laurena,Laurine	Laurie
Laurel	Laurie
Laverne,Laverna	Verna
Lavinia	Vina,Vinnie
Leah,Lea,Lee,Leigh
Lena 
Leona	Lee
Leonora,Leonore,Lenora,Lenore	Nora
Leslie,Lesley	Les
Leticia,Letitia	Lettie,Tisha
Lillian,Lilian	Lily,Lilly,Lili,Lilli,Lil,Lillie
Lily,Lilly,Lili,Lilli	Lil,Lillie
Linda,Lynda	Lindy,Lin,Lynn,Lynne
Lisa 
Lois 
Lora	Lori,Lorie,Lorri,Lorrie
Lorena,Lorene,Loreen,Loren,Lorine	Lori,Lorie,Lorri,Lorrie
Lorna
Loretta,Lorette	Lori,Lorrie,Etta,Retta
Lorinda,Laurinda	Lori,Lorie,Lorrie,Laurie
Lorraine,Lorrain,Loraine	Lora,Lori,Lorie,Lorrie
Lottie,Lotty,Lotta 
Louise,Louisa	Lou,Lu,Lulu,Lula,Lois
Lucille,Lucile	Lu,Lucy,Lucky
Lucinda	Lu,Lucy,Lucky,Cindy
Lucy,Lucie,Luci,Lucia	Lu,Lulu,Luce
Lydia	Liddy,Lyddie
Lynn,Lynne 
Mabel,Mabelle,Mable	Mab,Mabs
Madeline,Madeleine,Madelyn	Maddie,Maddy,Mady
Magdaline,Magdalen,Magdalena	Magda,Magsie,Lena
Marcia	Marcie,Marcy,Marci
Margaret,Margarita,Marguerite,Margret	Maggie,Marge,Margie,Marjorie,Margery,Madge,Margot,Margo,Magsie,Maisie,Daisy,Mamie,Maidie,Mae,May,Meg,Megan,Peggy,Greta,Gretchen,Rita
Marianne,Marianna,Maryann,Maryanne,Marian	Mary,Ann
Marilyn,Marilynn,Marylin,Marlene,Marlyn	Mary,Lynn
Maribel,Maribelle	Mary,Bell
Marietta,Mariett,Mariette	Mary,Etta,Ettie,Etty
Marina
Marion
Marjorie,Marjory,Margery	Marge
Martha,Marta	Marty,Mat,Mattie,Matty,Pat,Pattie,Patty
Mary,Maria,Marie
Mary	Mae,May,Moll,Molly,Mollie,Polly,Mamie,Mimi,Minnie
Matilda,Mathilda	Mat,Matty,Mattie,Maud,Maude,Patty,Pattie,Tilda,Tillie,Tilly
Maud,Maude	Maudie
Maureen	Maury
Maxine	Max,Maxie
Megan	
Melanie	Mel,Mellie
Melinda	Mel,Mellie,Linda,Mindy
Melissa	Mel,Mellie,Missie,Missy,Lisa,Lissa,Melisa
Mercedes	Mercy,Sadie
Meredith	Merry
Michelle,Michele	Mickey,Shelly
Mildred	Millie,Milly
Millicent,Milicent,Melicent	Millie,Milly
Minnie,Minna,Mina 
Miranda	Randy
Miriam
Molly,Mollie	Moll
Monica	Nicki
Muriel
Myra,Mira
Nadine	Nada,Dee
Natalie,Nathalie,Natalia,Natasha	Nattie,Natty
Nancy 
Nell,Nelle	Nellie
Nettie,Netty,Netta 
Nicole	Nicky,Nicki,Nikki,Nikky
Nina 
Nora 
Norma	Normie
Octavia	Tave,Tavy,Tavia
Olive,Olivia	Ollie,Olly,Nollie,Livvy,Livia
Ophelia
Pamela	Pam,Pammie,Pammy
Patricia	Pat,Patty,Patti,Pattie,Patsy,Tricia,Trisha,Trish,Trissie
Paula,Paulina,Pauline	Paulie
Pearl	Pearlie
Peggy	
Penelope	Pen,Penny
Phoebe,Phebe	Pheb
Phyllis	Phyl,Phyllie,Phil
Polly 
Priscilla	Prissy
Prudence	Prudie,Prudy,Prue,Pru
Rachel	Rachie,Rae,Ray
Raquel	Kelly,Kellie
Rebecca	Beck,Becky,Reba
Regina	Reggie,Ray,Gina,Ginny,Rena
Renata	Nata,Natie,Rennie,Renny,Renae
Renee,Rene,Renae 
Rhoda	Rodie
Rhonda
Roberta	Robbie,Robby,Robin,Robyn,Bobbie,Bobby,Berta,Bertie
Rose,Rosa	Rosie,Rosy
Rosabel,Rosabelle,Rosabella	Rose,Rosie,Rosy,Bell
Rosalie,Rosalee	Rose,Rosie,Rosy
Rosaline,Rosalyn	Rose,Rosie,Rosy
Rosalind,Rosalinda	Rose,Rosie,Rosy,Linda
Roseanna,Rosanna,Rosanne	Rose,Rosie,Rosy
Rosemary,Rosemarie	Rose,Rosie,Rosy
Roxanne,Roxanna,Roxana	Roxie,Roxy
Ruby,Rubina	Ruby,Rubie
Ruth	Ruthie
Sabrina	Brina,Sabby
Samantha	Sam,Sammie,Sammy
Sarah,Sara	Sal,Sally,Sallie,Sadie
Selina,Selena,Selene,Celine,Celina,Celena	Lena,Lina
Shannon
Sharon,Sharron
Sheila
Shirley,Shirlee,Shirlie	Shirl
Sibyl,Sybil,Sibylle,Syble	Sib,Sibbie
Sonia,Sonya
Sophia	Sophie,Sophy
Stacy,Stacey,Stacie,Staci 
Stephanie,Stephany,Stephania,Stephana,Stefanie,Stefania,Stefana,Steffanie	Steph,Stephie,Steff,Steffy,Stevie
Stella 
Susan,Susanna,Susannah,Susanne,Suzanne	Sue,Susie,Susi,Susy,Suzie,Suzy,Sukie
Sylvia,Silvia	Syl,Sylvie
Tabitha	Tabby
Tamara,Tamar	Tammy,Tammie
Tanya,Tania
Teresa,Theresa,Therese	Terry,Terri,Teri,Terrie,Tess,Tessa,Tessie,Tracy,Trissie
Theodora	Dora,Theo
Thelma
Tiffany	Tiff,Tiffy
Tina 
Tracy,Tracey,Tracie,Traci 
Ulrica,Ulrika
Ursula	Ursa,Ursie,Sulie
Valentina	Val,Vallie
Valerie,Valery,Valeria	Val,Vallie
Vanessa	Van,Vannie,Nessa
Vera
Verna 
Veronica	Nicky,Nicki,Ronnie,Ronni,Ronny
Victoria	Vic,Vick,Vickie,Vicky,Vicki,Viki,Vikki
Vida
Viola	Vi
Violet,Violette,Violetta	Vi,Lettie
Virginia	Ginger,Ginny,Jinny,Jenny,Virgie
Vivian,Vivien	Viv
Wanda
Wendy 
Wilhelmina	Willa,Wilma,Willie,Billie,Mina,Minnie
Winifred	Winnie,Freda,Freddie
Yolanda,Yolande
Yvonne	Vonnie,Vonna
Yvette	Vettie,Vetta
Zoe	Zoey.
Abigail	Abby,Nabby,Gail
Adaline,Adeline	Ada,Addy,Dell,Delia,Lena
Adelaide	Addy,Adele,Dell,Della,Heidi
Adelphia	Adele,Addy,Dell,Delphia,Philly
Agatha	Aggy
Agnes	Aggy,Inez,Nessa
Aileen	Allie,Lena
Alberta	Allie,Bert,Bertie
Alexandra	Alex,Alla,Sandy
Alfreda	Alfy,Freda,Freddy,Frieda
Alice,Alicia	Allie,Elsie,Lisa
Almena	Allie,Mena
Amanda	Manda,Mandy
Amelia	Emily,Mel,Millie,Amy
Ann,Anne	Annie,Nan,Nanny,Nana
Ann is sometimes a nickname for Antoinette,Christiana,
Roseanne,etc.)
Antoinette,Antonia	Ann,Tony,Netta
Arabella,Arabelle	Ara,Arry,Belle,Bella
Arlene	Arly,Lena
Armena	Arry,Mena
Asenath	Assene,Natty,Sene
Augusta,Augustina	Aggy,Gatsy,Gussie,Tina
Barbara	Bab,Babs,Barby,Bobbie
Beatrice	Bea,Trisha,Trix,Trixie
Belinda	Belle,Linda
Bertha	Birdie,Bert,Bertie
Bridget	Biddie,Biddy,Bridgie,Bridie
Camille	Cammie,Millie
Cornelia	Cornie,Nelia
Carol,Caroline,Carolyn	Carrie,Cassie,Lynn
Cassandra	Cassie,Sandra,Sandy
Catherine,Cathleen,Katherine,Kathleen	Cathy,Kathy
Katy,Cassie,Kay,Kit,Kittie,Trina,Lena
Cecilia	Celia,Cissy
Charlotte	Char,Lottie,Lotta,Sherry
Christine,Christina,Christiana,Kristine,etc.	Chris
Kris,Crissy,Christy,Kristy,Tina
Clarinda	Clara
Clarissa	Clara,Cissy
Constance	Connie
Cordelia	Cordy,Delia
Cornelia	Corny,Nelle,Nelly,Nelia
Cynthia	Cindy,Cintha
Dana
Darlene	Lena,Darry
Deborah,Debora	Debby,Debbie,Deb
Deliverance	Della,Delly,Dilly
Delores	Dell,Lola,Lolly,Della,Dee
Dicey	Dicie
Dorcus	Darkey
Dorothy	Dolly,Dot,Dortha
Edith	Edie
Elaine	
Eleanor	Elaine,Ellen,Ellie,Lanna,Lenora,Nelly,Nora
Elizabeth	Eliza,Bess,Bessie,Beth,Betsy,Betty,Lib,Libby,Liza,Lisa,Liz,Lizzie
Ellen	
Elmira	Elly,Ellie,Mira
Elouise	Louise
Elsie	
Emily	Emmy,Millie,Emma
Emeline	Em,Emily,Emma,Emmy,Milly
Estelle,Estella	Essy,Stella
Esther	
Evaline	Eva,Eve,Lena
Faith	Fay
Fidelia	Delia
Florence	Flo,Flora,Flossy
Frances	Fanny,Fran,Cissy,Frankie,Sis
Fredericka	Freda,Freddy,Ricka,Frieda
Gabrielle,Gabriella	Gabby,Ella
Gail	
Genevieve	Eve,Jean,Jenny
Geraldine	Dina,Gerry,Gerrie,Jerry
Gertrude	Trudy,Gert,Gertie
Gwendolyn	Gwen,Wendy
Hannah	Nan,Nanny,Anna,Susannah.
Harriet	Hattie
Heidi	
Helen,Helene	Ella,Ellen,Ellie,Lena
Heloise	Eloise,Lois
Henrietta	Etta,Etty,Hank,Nettie,Retta
Hermione	Hermie
Hepsibah,Hephsibah	Hipsie
Hester	Hessy,Esther,Hetty
Ina	
Inez	
Irene	Rena
Isabel,Isabelle,Isabella	Bella,Belle,Ib,Issy,Nib,Nibby,Tibbie
Isadora	Dora,Issy
Jane	Janie,Jean,Jennie,Jessie
Janet	Jessie,Jan
Jean,Jeanne	Jane,Jeannie
Jeanette	Janet,Jean,Jessie,Nettie
Jemima	Mima
Jennifer	Jennie
Jessica	Jessie
Joan	Nonie,Johannah
Joanna,Johannah	Joan,Jody,Hannah
Josephine	Jody,Jo,Joey,Josey,Fina
Joyce	Joy
Juanita	Nettie,Nita
Julia	Julie,Jill
Keziah	Kizza,Kizzie
Lavina,Lavinia	Ina,Vina,Viney
Lenora	Nora,Lee
Letitia	Lettie,Lettice,Titia,Tish
Lillah	Lily,Lilly,Lil,Lolly
Lillian	Lil,Lilly,Lolly
Linda	Lindy,Lynn
Melinda,Philinda,etc.
Lisa	Alice,Melissa
Lois	Louise
Loretta	Etta,Lorrie,Retta
Lorraine	Lorrie
Louise,Louisa	Lou,Eliza,Lois
Lucille	Lu,Lou,Cille,Lucy
Lucinda	Cindy,Lu,Lou,Lucy
Luella	Ella,Lu,Lula
Lydia,Lidia	Lyddy
Lynn	Madeline,Linda,etc.
Madeline	Lena,Maddy,Madge,Magda,Maggie
Maida,Maud
Magdelina	Lena,Madge,Magda
Mahala	Hallie
Margaret,Margaretta	Daisy,Gretta,Madge,Maggie
Meg,Midge,Peg,Peggy,Rita,Margery,Marge,Margie
Martha	Marty,Mat,Mattie,Patsy,Patty
Mary	Molly,Polly,Mae,Mamie,Mitzi
Matilda	Tilly,Matty,Maud
Mehitabel	Hetty,Hitty,Mabel,Mitty
Melinda	Linda,Lindy,Mel,Mindy
Melissa	Lisa,Lissa,Mel,Milly,Missy
Michelle	Mickey
Mildred	Milly
Millicent	Milly,Missy
Minerva	Minnie
Miranda	Mandy,Mira,Randy
Miriam	Mimi,Mitzi
Nancy	Nan
Natalie	Natty,Nettie
Olive,Olivia	Ollie,Nollie,Livia
Parmelia	Amelia,Melia,Milly
Patience	Pat,Patty
Patricia	Pat,Patty,Patsy,Tricia
Paula,Paulina	Polly,Lina
Penelope	Penny
Philinda	Linda
Priscilla	Cissy,Cilla,Prissy
Prudence	Prudy,Prue
Rachel	Shelly
Rebecca	Reba,Becca,Becky,Beck
Regina	Reggie,Gina
Relief	Leafa
Roberta	Bobbie,Robbie,Bert
Rosabel,Rosabella	Belle,Rosa,Rose,Roz
Rosalyn,Rosalinda	Rosa,Rose,Linda,Roz
Roseann,Roseanna	Rose,Ann,Roz,Rosie
Roxanne,Roxanna	Ann,Rose,Roxie
Sabrina	Brina
Sandra	Sandy,Alexandra
Sarah	Sally,Sadie
Selina	Lena
Serena	Rena
Shirley	Lee,Sherry,Shirl
Submit	Mitty
Susan,Susannah	Sue,Sukey,Susie,Hannah
Tabitha	Tabby
Theresa	Terry,Tess,Tessie,Tessa,Thirza,Thursa,Tracy
Tryphena	Phena
Valerie	Val
Vanessa	Nessa,Essa,Vanna
Veronica	Franky,Frony,Ron,Ronnie,Ronna,Vonnie
Victoria	Vicky
Virginia	Ginger,Ginny,Jane,Jennie,Virgy
Wilhelmina	Mina,Willie,Wilma,Minnie
Winifred	Winnie,Freddie,Winnet
